5 8
########
#  .   #
#  @   #
#  $   #
########
