9 8
  #####
###   #
#.$@  #
### @.#
#.##@ #
# # . ##
#@@.@@.#
#   .  #
########